0001000000
1101111100
1000000111
1000000001
1101111101
0100100101
0111110111
0000010000
